WWWWW
W  PW
W V W
W  AW
WWWWW
