WWWWWWWWWWWWWWWWW
W               W
W          W   WW
W          W  BWW
W         HWWWWWW
W     W  W      W
W     W  W      W
W     W AW      W
WWWWWWWWW       W
W P       V     W
W               W
WWWWWWWWWWWWWWWWW
