WWWWWWWWWWWWWWWWWWWWWWWWWWWWWWWWWWWWWWWWWWWWWWWWWWWWWWWWWWWWWWWWWWWWWWWWWWWWWWWWWWWWWWW
W                              W         W             V  W          W           H    W
WWWW        WWWWWWWWWWW        W         WB               W        VAW           WWWWWW
WA             H               W         WWWWWWWWWWW      W       WWWW                W
W          WWWWW               W                  AW      W                           W
W H                 WWWWWWWWWWWW       WWWWWWWWWWWWW                WWWW       WWWWWWWW
WWWWWWWWWWWWWWWWV                                       WWW         WWWW              W
W                                   H     WWWWWWWWWWW   WBW         WWWW              W
WW          WWWWWWWWWWWWWWWWWW            W               W         WWWW         WWWWWW
WP                           H            W               W                          BW
WWWWWWWWWWWWWWWWWWWWWWWWWWWWWWWWWWWWWWWWWWWWWWWWWWWWWWWWWWWWWWWWWWWWWWWWWWWWWWWWWWWWWWW