WWWWWWWWWWWWWWW
W   H   H WH  W
WWW WP H WA   W
WW W W  VWW   W
W V    W    W W
W BWW  B  WW WW
WB   W   A   AW
W    W  WA BW W
W B  W        W
WWWWWWWWWWWWWWW