WWWWWWWWWWWWWWWWWWWWWWWWWWWWWW
W   WB    A   HW    W   H B  W
W   B W  B H  W H  A W  W W  W
W   HW   W B  BB   W W  AW   W
W   B A  WVW  W V  WAW  W W  W
WP  BW   W W  BW   W A  H A  W
WWWWWWWWWWWWWWWWWWWWWWWWWWWWWW